R 900 600
S ./pics/barrel.xpm
NO ./pics/stone.xpm
SO ./pics/stone.xpm
WE ./pics/wood.xpm
EA ./pics/wood.xpm
F 0,0,0
C 0,0,0




1111111111111
110000000111111111111111111111111
12000000E000000000000000000000001
110002000111111111111111111111111
1000000011
1010000001
1111111111
