      R 1920 1080
            NO                ./pics/stone.xpm                
SO ./pics/hexagone.xpm
WE ./pics/redbrick.xpm
EA ./pics/wood.xpm
S ./pics/barrel.xpm
F ,,
C 225,30,10
         11111111111111111111111
        1000000000110000000000001
        1001000000110000000000001
        1001000000000002W00002021
111111111011000001000010000000021
100000000011000001000000000011111
11110111111111011000000000001
11110111111111011000000000001
11000000110101011000000000001
10000000000000000000000000001
10000000000000000000000000001
11000011101010111000000000101
11110111 1110101 100000000001
11111111 1111111 111111111111