R 1920 1080 
NO ./pics/stone.xpm              
SO ./pics/hexagone.xpm
WE ./pics/redbrick.xpm
EA ./pics/wood.xpm
S ./pics/barrel.xpm
F 100,100,255
C 215,100,100
11111111111111111111111111111111
        1000000000110000000000001
        1001000000110000000000001
        1001000000000002W0000202111
111111111011000001000010011100000021
10000000001100000100000001 11111111
11110111111111011000000001111
111101111111110110000000000001
11000000110101011000000000001
10000000000000000000000000001
10000000000000000000000000001
11000011101010111000000000101
11110111 1110101 100000000001
11111111 1111111 111111111111
111
101
111

2800 4068 4059 4077
4200 4074 4084 4085