        1111111111111111111111111
        1000000000110002002000001
        1011000001110000000000001
        100100000000000000N000001
111111111011000001110000000000001
100000000011000001110110110111111
11110111111111011100000010001
11110111111111011101010010001
11000000110101011100000010001
10000000000000000000000000001
10000000000000001101010010001
11000011101010111010110000101
11110111 1110101 121211010001
11111111 1111111 111111011111
                      101
                      101
                      101
                      101
                      101
                      101
                      101
                      101
                      101
                      101
                      101
                      101
                      101
                      101
                      101
                      101
                      101
                      101
                      101
                      101
                      101
                      111 