R 960 700
S ./pics/dog.xpm
NO ./pics/dog.xpm   
SO ./pics/dog.xpm
WE ./pics/dog.xpm             
EA ./pics/dog.xpm        
F 200,20,230            
C 25,250,230         





1111111111
1000000001
10000000E1
1200000001
1000000011
1210000001
1111111111