R 1873 555
S ./pics/barrel.xpm

NO ./pics/stone.xpm              
SO                                 ./pics/hexagone.xpm
WE   ./pics/redbrick.xpm             
                EA                 ./pics/wood.xpm        
               F              200              ,              20     ,           230            
C 25,250,230         





1111111111
1000000W01
1000000001
1000000001
1000000011
1010000001
1111111111