         11111111111111111111111
        1000000000110000000000001
        1001000000110000000000001
        100100000000000000W000021
111111111011000001000010000000001
100000000011000001000000020011111
11110111111111011000000000001
11110111111111011000000000001
11000000110101011000000000001
10000000000000000000000000001
10000000000000000000000000001
11000011101010111000000000101
11110111 1110101 100000002001
11111111 1111111 111111111111