R 900 600
S ./pics/barrel.xpm
NO ./pics/stone.xpm
SO ./pics/hexagone.xpm
WE ./pics/redbrick.xpm
EA ./pics/wood.xpm
F 200,20,230
C 255,255,255




1111111111111
110000000111111111111111111111111
12000000S000000000000000000000001
110002000111111111111111111111111
1000000011
1010000001
1111111111
